10 10
##########
      ####
##### ####
#   #    #
# # # ## #
# # # ## #
# # # #  #
# ### ## #
#     ##  
##########
