15 19
###################
  #      # #   #   
# # # ## # # # # ##
# # ####   # # # ##
# #    # # # # # ##
# # #### # # # # ##
# #    # ### # # ##
# #### # #   # # ##
#   #  #   # # # ##
#   # #  #####    #
# # # #       ##  #
# # # #############
# # #   #   #   # #
# #   #   #   #   #
###################